24 29 27 27 27 30 24 29 27 27 27 30 24 00 24 29 36 30 24 00
24 25 40 40 40 13 27 28 40 40 40 23 24 00 24 25 -1 23 24 00
24 25 -1 -1 -1 40 40 40 -1 -1 -1 23 24 24 24 25 -1 23 24 24
24 25 -1 -1 -1 -1 -1 -1 -1 -1 -1 23 24 24 29 28 -1 13 30 24
24 25 -1 -1 -1 04 07 05 -1 -1 -1 13 30 29 28 40 -1 40 13 30
24 25 -1 -1 -1 23 24 25 -1 -1 -1 41 23 25 40 -1 -1 -1 40 23
24 25 -1 -1 -1 23 29 28 -1 -1 -1 41 23 25 -1 -1 -1 -1 -1 23
24 25 -1 -1 -1 23 25 43 -1 -1 -1 08 32 25 -1 -1 -1 -1 -1 23
24 25 -1 -1 -1 23 25 43 -1 -1 -1 13 30 25 -1 -1 -1 -1 -1 23
24 25 -1 -1 -1 23 31 22 -1 -1 -1 41 23 25 -1 -1 -1 -1 -1 23
24 25 -1 -1 -1 23 24 25 -1 -1 -1 41 23 25 -1 -1 -1 -1 -1 23
24 25 -1 -1 -1 23 29 28 -1 -1 -1 08 32 25 -1 -1 -1 -1 -1 23
24 31 07 07 07 32 25 43 -1 -1 -1 13 27 28 -1 -1 -1 -1 -1 23
24 24 24 24 24 24 25 43 -1 -1 -1 -1 -1 -1 -1 -1 -1 -1 -1 23
00 00 00 00 00 24 31 07 07 07 07 07 07 07 07 07 07 07 07 32
60 330
480 0
90 90 450 270