-1 -1 -1 -1 23 25 43 -1 -1 -1 -1 -1 -1 -1 23 29 27 36 27 30
-1 -1 -1 -1 13 28 43 -1 -1 -1 -1 -1 -1 -1 13 28 -1 -1 41 23 
-1 -1 -1 -1 -1 -1 -1 -1 -1 -1 -1 -1 -1 -1 -1 -1 -1 -1 41 23 
-1 -1 -1 -1 -1 -1 -1 -1 -1 -1 -1 -1 -1 -1 -1 -1 -1 -1 41 23 
07 05 -1 -1 04 05 -1 -1 -1 -1 -1 -1 -1 41 04 05 -1 -1 04 32 
27 28 -1 -1 13 28 -1 -1 -1 -1 -1 -1 -1 41 13 28 -1 -1 13 27 
-1 -1 -1 -1 -1 -1 -1 -1 -1 -1 -1 -1 -1 -1 -1 -1 -1 -1 -1 -1 
-1 -1 -1 -1 -1 -1 -1 -1 -1 -1 -1 -1 -1 -1 -1 -1 -1 -1 -1 -1 
-1 -1 -1 -1 -1 -1 -1 -1 -1 -1 -1 -1 -1 -1 -1 -1 -1 -1 -1 -1 
07 05 -1 -1 04 05 43 -1 -1 -1 -1 -1 -1 -1 04 05 -1 -1 04 07 
29 28 -1 -1 13 28 43 -1 -1 -1 -1 -1 -1 -1 13 28 -1 -1 13 27 
25 -1 -1 -1 -1 -1 -1 -1 -1 -1 -1 -1 -1 -1 -1 -1 -1 -1 -1 -1 
25 -1 -1 -1 -1 -1 -1 -1 -1 -1 -1 -1 -1 -1 -1 -1 -1 -1 -1 -1 
25 -1 -1 -1 04 05 -1 -1 -1 -1 -1 -1 -1 41 04 05 -1 -1 -1 -1 
31 07 07 07 32 25 -1 -1 -1 -1 -1 -1 -1 41 23 25 -1 -1 -1 -1 
2
1 13 0
18 1 1
6
6 3 10 1 0 18
6 16 10 3 0 18
6 2 5 3 0 18
6 17 5 1 0 18
5 10 14 0 59
5 9 0 40 59